00,00,00,00,00,00,00,00,00,00,00,00,00,00,00,00,00,00,00,00,00,00,00,00,00,00,00,00,00,00,00,00,00,00,00,00,00,00,00,00,00,00,00,00,00,00,00,00,00,00,00,00,00,00,00,00,00,00,00,00,00,00,00,00,00,00,00,00,00,00,00,00,00,00,00,00,00,00,00,00,00,00,00,00,00,00,00,00,00,00,00,00,00,00,00,00,00,00,00,00
00,00,00,00,00,00,00,00,00,00,00,00,00,00,00,00,00,00,00,00,00,00,00,00,00,00,00,00,00,00,00,00,00,00,00,00,00,00,00,00,00,00,00,00,00,00,00,00,00,00,00,00,00,00,00,00,00,00,00,00,00,00,00,00,00,00,00,00,00,00,00,00,00,00,00,00,00,00,00,00,00,00,00,00,00,00,00,00,00,00,00,00,00,00,00,00,00,00,00,00
00,00,00,00,00,00,00,00,00,00,00,00,00,00,00,00,00,00,00,00,00,00,00,00,00,00,00,00,00,00,00,00,00,00,00,00,00,00,00,00,00,00,00,00,00,00,00,00,00,00,00,09,10,11,09,10,10,11,09,10,10,11,00,00,04,00,00,04,00,09,10,10,10,10,10,10,10,10,10,10,10,10,10,10,10,10,10,10,10,10,10,10,10,10,10,10,10,10,10,11
00,00,00,00,00,00,00,00,00,00,00,00,00,00,00,00,00,00,00,00,00,00,00,00,00,00,00,00,00,00,00,00,00,00,00,00,00,00,00,00,00,04,00,00,00,00,00,00,00,00,00,09,10,11,09,10,10,11,09,10,10,11,00,00,04,00,00,04,00,09,10,10,10,10,10,10,10,10,10,10,10,10,10,10,10,10,10,10,10,10,10,10,10,10,10,10,10,10,10,11
00,00,00,00,00,00,09,24,00,00,00,00,00,00,00,09,10,10,10,11,00,00,00,00,00,00,00,00,04,00,00,04,00,00,00,00,00,00,00,00,00,04,00,00,00,00,00,00,00,00,00,09,10,11,09,10,10,11,09,10,10,11,00,00,04,00,00,04,00,09,10,10,10,10,10,10,10,10,10,10,10,10,10,10,10,10,10,10,10,10,10,10,10,10,10,10,10,10,10,11
00,00,00,00,00,00,09,24,00,00,00,00,00,00,00,09,10,10,10,11,00,00,00,00,00,00,00,00,04,00,00,04,00,00,00,00,00,00,00,00,00,04,00,00,00,00,00,00,00,00,00,09,10,11,09,10,10,11,09,24,24,11,00,00,04,00,00,04,00,09,10,10,10,10,10,10,10,10,10,10,10,10,10,10,10,10,10,10,10,10,10,10,10,10,10,10,10,10,10,11
00,00,00,00,00,00,09,24,00,00,00,00,00,00,00,09,10,10,10,11,00,00,00,00,00,00,00,00,04,00,00,04,00,00,00,00,00,00,00,00,00,04,00,00,00,00,00,00,00,00,00,09,10,11,09,10,10,11,09,24,24,11,00,00,04,00,00,04,00,00,00,00,00,00,00,00,00,00,00,00,00,00,00,00,00,00,00,00,00,00,00,00,00,00,00,00,00,00,00,00
00,00,00,00,00,00,09,24,00,00,00,00,00,00,00,09,10,10,10,11,00,00,00,00,00,00,00,00,04,00,00,04,00,00,00,00,00,82,05,83,00,04,00,00,00,00,00,00,00,00,00,09,10,11,09,10,10,11,09,24,24,11,00,00,04,00,00,04,00,00,00,00,00,00,00,00,00,00,00,00,00,00,00,00,00,00,00,00,00,00,00,00,00,00,00,00,00,00,00,00
00,00,00,00,00,00,09,24,00,00,00,00,00,00,00,09,10,10,10,11,00,00,00,00,00,00,00,00,04,00,00,04,00,00,00,00,00,82,05,83,00,04,00,00,00,00,00,00,00,00,00,09,10,11,09,10,10,11,09,24,24,11,00,00,04,00,00,04,00,00,00,00,00,00,00,00,00,00,00,00,00,00,00,00,00,00,00,00,00,00,00,00,00,00,00,00,00,00,00,00
00,00,00,00,00,00,09,24,00,00,00,00,00,00,00,09,10,10,10,11,00,00,00,00,00,00,00,00,04,00,00,04,00,00,00,00,00,00,00,00,00,04,00,00,00,00,00,00,00,00,00,09,10,11,09,10,10,11,09,24,24,11,00,00,04,00,00,04,00,00,00,00,00,00,00,00,00,00,00,00,00,00,00,00,00,00,00,00,30,30,30,30,30,30,30,00,00,00,00,00
00,00,00,00,00,00,09,24,00,00,00,00,00,00,00,09,10,10,10,11,00,00,00,00,00,00,00,00,04,00,00,04,00,00,00,00,00,00,00,00,00,04,00,00,00,00,00,00,00,00,00,09,10,11,09,10,10,11,09,24,24,11,00,00,04,00,00,04,00,09,30,30,30,30,30,30,30,30,30,30,30,30,30,30,30,30,30,30,30,30,30,30,30,30,30,30,30,30,30,11
00,00,00,00,00,00,09,24,00,00,00,00,00,00,00,09,10,10,10,11,00,00,00,00,00,00,00,00,04,00,00,04,00,00,00,00,00,19,05,19,00,04,00,00,00,00,00,00,00,00,00,09,10,11,09,10,10,11,09,24,24,11,00,00,04,00,00,04,00,09,30,30,30,30,30,30,30,30,30,30,30,30,30,30,30,30,30,30,30,30,30,30,30,30,30,30,30,30,30,11
00,00,00,00,00,00,09,24,00,00,00,00,00,00,00,09,10,10,10,11,00,00,00,00,00,00,00,00,04,00,00,04,00,00,00,00,00,00,00,00,00,04,00,00,00,00,00,00,00,00,00,09,10,11,09,10,10,11,09,24,24,11,00,00,04,00,00,04,00,09,30,30,30,30,30,30,30,30,30,30,30,30,30,30,30,30,30,30,30,30,30,30,30,30,30,30,30,30,30,11
00,00,00,00,00,00,09,24,00,00,00,00,00,00,00,09,10,10,10,11,00,00,00,00,00,00,00,00,04,00,00,04,00,00,00,00,00,00,00,00,00,04,00,00,00,00,00,00,00,00,00,09,10,11,09,10,10,11,09,24,24,11,00,00,04,00,00,04,00,09,30,30,30,30,30,30,30,30,30,30,30,30,30,30,30,30,30,30,30,30,30,30,30,30,30,30,30,30,30,11
00,00,00,00,00,00,09,24,00,00,00,00,00,00,00,09,10,10,10,11,00,00,00,00,00,00,00,00,04,00,00,04,00,00,00,00,00,00,00,00,00,04,00,00,00,05,19,19,00,00,00,09,10,11,09,10,10,11,09,24,10,11,00,00,04,00,00,04,00,09,30,30,30,30,30,30,30,30,30,30,30,30,30,30,30,30,30,30,30,30,30,30,30,30,30,30,30,30,30,11
00,00,00,00,00,00,09,24,00,00,00,00,00,00,00,09,10,10,10,11,00,00,00,00,00,00,00,00,04,00,00,04,00,00,00,00,00,00,00,00,00,04,54,54,54,00,00,00,00,00,00,09,10,11,09,10,10,11,09,24,24,11,00,00,04,00,00,04,00,09,30,30,30,30,30,30,30,30,30,30,30,30,30,30,30,30,30,30,30,30,30,30,30,30,30,30,30,30,30,11
00,00,00,00,00,00,09,24,00,00,00,00,00,00,00,09,10,10,10,11,00,00,00,00,00,00,00,00,04,00,00,04,00,00,00,00,00,00,00,00,00,05,05,05,05,05,00,00,00,00,00,09,10,11,09,10,10,11,09,24,24,11,00,00,04,00,00,04,00,09,30,30,30,30,30,30,30,30,30,30,30,30,30,30,30,30,30,30,30,30,30,30,30,30,30,30,30,30,30,11
60,00,60,00,00,00,09,24,00,00,00,00,00,00,00,09,10,10,10,11,00,00,00,00,00,00,00,00,00,00,00,00,00,00,00,00,00,00,00,00,00,04,68,68,68,00,00,00,00,00,00,09,10,11,09,10,10,11,09,24,24,11,00,00,04,00,00,04,00,09,30,30,30,30,30,30,30,30,30,30,30,30,30,30,30,30,30,30,30,30,30,30,30,30,30,30,30,30,30,11
02,02,02,02,03,03,09,24,00,00,00,00,00,00,00,09,10,10,10,11,00,00,00,00,00,00,00,00,00,00,00,00,00,00,00,00,00,00,00,00,00,04,00,00,00,00,00,00,00,00,00,09,10,11,09,10,10,11,09,24,24,11,00,00,04,00,00,04,00,09,30,30,30,30,30,30,30,30,30,30,30,30,30,30,30,30,30,30,30,30,30,30,30,30,30,30,30,30,30,11
30,35,30,36,30,17,02,02,93,00,00,00,00,00,00,09,10,10,10,11,00,00,00,00,00,00,00,00,00,00,00,00,00,00,00,00,00,00,00,00,00,04,00,00,00,00,00,00,00,00,00,09,10,11,09,10,10,11,09,24,24,11,00,00,04,00,00,04,00,09,30,30,30,30,30,30,30,30,30,30,30,30,30,30,30,30,30,30,30,30,30,30,30,30,30,30,30,30,30,11
35,30,20,36,36,36,30,36,18,00,00,00,00,00,00,09,10,10,10,11,00,00,00,00,00,00,00,00,00,00,00,00,00,00,00,00,00,00,00,00,00,04,00,00,00,00,00,00,00,00,13,09,10,11,09,10,10,11,09,24,24,11,00,00,04,00,00,04,00,09,10,10,10,10,10,10,10,10,10,10,10,10,10,10,10,10,10,10,10,10,10,10,10,10,10,10,10,10,10,11
35,35,20,36,35,35,35,20,32,00,00,00,00,00,00,09,10,10,10,11,00,00,00,00,00,00,00,00,00,00,00,00,00,00,00,00,00,00,00,00,00,04,00,00,00,00,00,00,00,00,27,09,10,11,00,00,00,11,09,24,24,11,00,00,04,00,00,04,00,09,10,10,10,10,10,10,10,10,10,10,10,10,10,10,10,10,10,10,10,10,10,10,10,10,10,10,10,10,10,11
36,36,36,30,20,30,34,30,32,00,00,00,00,00,00,09,10,10,10,11,00,00,00,00,00,00,00,00,00,00,00,00,00,00,00,00,00,00,00,00,00,00,00,00,00,00,00,00,00,00,41,09,10,11,00,00,00,11,09,24,24,11,00,00,00,00,00,00,00,00,00,00,00,00,00,00,00,00,00,00,00,00,00,00,00,00,00,00,00,00,00,00,00,00,00,00,00,00,00,00
36,35,35,30,35,34,34,34,32,00,00,00,00,00,00,09,10,10,10,11,00,00,00,00,00,00,00,00,00,00,00,00,00,00,00,00,00,20,30,35,30,30,30,20,20,20,30,30,30,00,00,09,10,11,00,00,00,00,09,24,00,00,00,35,35,30,35,35,35,35,35,30,30,30,30,30,33,33,30,33,33,33,33,36,36,30,33,30,30,30,30,30,30,30,30,30,36,36,36,36
30,30,36,36,30,34,34,34,32,00,60,00,00,00,60,09,10,10,10,11,00,00,00,00,00,00,00,00,00,00,00,00,00,00,00,00,00,36,36,35,35,35,20,33,30,20,30,30,30,30,30,30,00,00,00,00,00,00,00,00,00,35,35,30,30,30,20,20,33,20,20,35,35,35,33,30,30,33,33,33,33,33,33,33,33,33,33,36,36,36,34,33,34,34,34,34,33,33,34,34
14,02,02,02,02,02,02,02,02,02,02,02,02,02,02,02,02,02,02,18,00,00,00,14,81,81,79,79,02,02,02,00,00,00,00,00,00,35,20,35,35,20,33,33,33,33,30,20,20,35,35,30,30,30,30,30,33,33,30,36,36,36,36,30,30,20,33,33,33,33,33,33,30,00,33,35,33,33,20,20,20,33,20,33,33,34,34,34,36,36,36,36,34,30,34,33,33,33,36,34
29,29,29,35,20,29,29,35,20,20,20,20,29,35,33,33,33,29,29,29,54,54,54,44,30,30,30,30,30,30,30,30,30,00,00,00,00,00,20,35,20,34,33,33,33,33,20,20,20,20,35,35,20,33,33,33,33,33,36,36,36,36,35,35,20,33,33,33,36,36,30,34,20,36,33,33,33,35,35,36,36,36,36,36,33,33,36,34,34,30,30,30,30,33,33,30,30,36,36,36
29,33,20,20,29,33,33,33,29,20,20,35,20,29,20,29,20,33,33,33,04,04,04,44,30,30,30,30,30,30,30,30,00,00,00,00,00,20,20,20,35,35,33,20,33,33,33,34,33,33,30,30,33,33,33,33,33,33,33,33,36,33,36,36,36,36,36,36,36,34,34,33,33,36,34,34,35,35,35,35,33,34,36,36,36,34,34,34,34,34,34,34,33,33,30,30,36,36,36,36
29,20,33,33,20,20,33,33,33,33,33,35,33,33,35,20,20,35,33,33,44,44,44,44,30,30,30,30,30,30,30,00,30,00,00,00,00,20,20,20,35,35,33,33,33,20,20,34,34,34,34,34,33,33,35,35,33,33,30,34,34,34,20,20,34,20,20,20,20,34,33,33,35,35,35,35,34,35,34,34,34,33,33,33,34,34,35,20,30,36,30,30,30,30,30,30,30,36,36,30
29,20,33,33,33,33,29,20,33,20,35,35,20,20,35,35,35,35,29,33,44,44,44,44,30,30,30,30,30,30,00,00,00,00,00,00,00,35,20,20,30,30,30,30,20,20,20,30,30,20,20,20,20,20,20,20,35,35,35,34,30,33,30,30,30,33,33,35,35,35,35,35,30,30,30,30,30,30,30,30,30,30,33,35,35,30,30,20,30,33,33,30,30,30,30,30,30,30,36,36