00,00,00,00,00,00,00,00,00,00,00,00,00,00,00,00,00,00,00,00,00,00,00,00,00,00,00,00,00,00,00,00,00,00,00,00,00,00,00,00,00,00,00,00,00,00,00,00,00,00,00,00,00,00,00,00,00,00,00,00,00,00,00,00,00,00,00,00,00,00,00,00,00,00,00,00,00,00,00,00,00,00,00,00,00,00,00,00,00,00,00,00,00,00,00,00,00,00,00,00
00,00,00,00,00,00,00,00,00,00,00,00,00,00,00,00,00,00,00,00,00,00,00,00,00,00,00,00,00,00,00,00,00,00,00,00,00,00,00,00,00,00,00,00,00,00,00,00,00,00,00,00,00,00,00,00,00,00,00,00,00,00,00,00,00,00,00,00,00,00,00,00,00,00,00,00,00,00,00,00,00,00,00,00,00,00,00,00,00,00,00,00,00,00,00,00,00,00,00,00
00,00,00,00,00,00,00,00,00,00,00,00,00,00,00,00,00,00,00,00,00,00,00,00,00,00,00,00,00,00,00,00,00,00,00,00,00,00,00,00,00,00,00,00,00,04,00,00,00,00,00,00,00,00,00,00,00,00,00,00,00,00,00,00,00,00,00,00,00,00,00,00,00,00,00,00,00,00,00,00,00,00,00,00,00,00,00,00,00,00,00,00,00,00,00,00,00,00,00,00
00,00,00,00,00,00,00,00,00,00,00,00,00,00,00,00,00,00,00,00,00,00,00,00,00,00,00,00,00,00,00,00,00,00,00,00,00,00,04,00,00,00,00,00,00,04,00,00,00,00,00,00,00,00,00,00,00,00,00,00,00,00,00,00,00,00,00,00,00,00,00,00,00,00,00,00,00,00,00,00,00,00,00,00,00,00,00,00,00,00,00,00,00,00,00,00,00,00,00,00
00,04,00,04,00,04,00,04,00,00,00,00,04,00,00,00,00,04,00,00,00,00,00,04,00,00,00,00,00,00,00,00,00,00,00,00,00,00,04,00,00,00,00,00,00,04,00,00,00,00,00,00,00,00,00,00,00,00,00,00,00,00,00,00,00,00,00,00,00,00,00,00,00,00,00,00,00,00,00,00,00,00,00,00,00,00,00,00,00,00,00,00,00,00,00,00,00,00,00,00
00,04,00,04,00,04,00,04,00,00,00,00,04,00,00,00,00,04,00,00,00,00,00,04,00,00,00,00,00,00,00,00,00,00,00,00,00,00,04,00,00,00,00,00,00,04,00,00,00,00,00,00,00,00,00,00,00,00,00,00,00,00,00,00,00,00,00,00,00,00,00,00,00,00,00,00,00,00,00,00,00,00,00,00,00,00,00,00,00,00,00,00,00,00,00,00,00,00,00,00
00,04,00,04,00,04,00,04,00,00,00,00,04,00,00,00,00,04,00,00,00,00,00,04,00,00,00,00,00,00,00,00,00,00,00,00,00,00,04,00,00,00,00,00,00,04,00,00,00,00,00,00,00,00,00,00,00,00,00,00,00,00,00,00,00,00,00,00,00,47,48,48,48,48,48,48,48,48,48,48,48,48,48,48,48,48,48,48,48,48,48,48,48,48,48,48,48,48,48,49
00,04,00,04,00,04,00,04,00,00,00,00,04,00,00,00,00,04,00,00,00,00,00,04,00,00,00,00,00,00,00,00,00,00,00,00,00,00,04,00,00,00,00,00,00,04,00,00,00,00,00,00,00,00,00,00,00,00,00,00,00,00,00,00,00,00,00,00,00,61,62,62,62,62,62,62,62,62,62,62,62,62,62,62,62,62,62,62,62,62,62,62,62,62,62,62,62,62,62,63
00,04,00,04,00,04,00,04,00,00,00,00,04,00,00,00,00,04,00,00,00,00,00,04,00,00,00,00,00,00,00,00,00,00,00,00,00,00,04,00,00,00,00,00,00,04,00,00,00,00,00,00,00,00,00,00,00,00,00,00,00,00,00,00,00,00,00,00,00,61,76,76,76,76,76,76,76,76,76,76,76,76,76,76,76,76,76,76,76,76,76,76,76,76,76,76,76,76,76,63
00,04,00,04,00,04,00,04,00,00,00,00,04,00,00,00,00,04,00,00,00,00,00,04,00,00,00,00,00,00,00,00,00,00,00,00,00,00,04,00,00,00,00,00,00,04,00,00,00,00,00,00,00,00,00,00,00,00,00,00,00,00,00,00,00,00,00,00,00,75,76,76,76,76,76,76,76,76,76,76,76,76,76,76,76,76,76,76,76,76,76,76,76,76,76,76,76,76,76,77
00,05,05,05,05,05,05,05,05,05,05,05,05,00,00,00,00,04,00,00,00,00,00,04,00,00,00,19,05,19,19,05,19,00,00,00,00,00,04,00,00,00,00,00,00,04,00,54,00,00,00,00,00,00,00,00,00,00,00,00,00,00,00,00,00,00,00,00,00,00,00,00,00,00,00,00,00,00,00,00,00,00,00,00,00,00,00,00,00,00,00,00,00,00,00,00,00,00,00,00
00,04,68,04,68,04,68,04,68,68,68,68,04,00,00,00,00,04,00,00,00,00,00,04,00,00,00,00,00,00,00,00,00,00,00,00,00,00,04,00,00,00,00,00,00,04,82,05,83,00,00,00,00,00,00,00,00,00,00,00,00,00,00,00,00,00,00,00,00,00,00,00,00,00,00,00,00,00,00,00,00,00,00,00,00,00,00,00,00,00,00,00,00,00,00,00,00,00,00,00
00,04,00,04,00,04,00,04,00,00,00,00,04,00,00,00,00,04,00,00,00,00,00,04,00,00,00,00,00,00,00,00,00,00,00,00,00,00,04,00,00,00,00,00,00,04,00,04,00,00,00,00,00,00,00,00,00,00,00,00,00,00,00,00,00,00,00,00,00,00,00,00,00,00,00,00,00,00,00,00,00,00,00,00,00,00,00,00,00,00,00,00,00,00,00,00,00,00,00,00
00,04,00,04,00,04,00,04,00,00,00,00,04,00,00,00,19,05,19,00,00,00,19,05,19,00,00,00,00,00,00,00,00,00,00,00,00,00,04,00,00,00,00,00,00,04,00,04,00,00,00,00,00,00,00,00,00,00,00,00,00,00,00,00,00,00,00,00,00,00,00,00,00,00,87,87,87,87,87,87,87,87,00,00,00,00,00,00,00,00,00,00,00,00,00,00,00,00,00,00
00,04,00,04,00,04,00,04,00,00,00,00,04,00,00,00,00,04,00,00,00,00,00,04,00,00,00,00,00,00,00,00,00,00,00,00,00,00,04,00,00,00,00,00,00,04,00,05,19,05,83,00,00,00,00,00,00,00,00,00,00,00,00,00,00,00,00,00,00,00,00,00,00,00,73,73,73,73,73,73,73,73,00,00,00,00,00,00,00,00,00,00,00,00,00,00,00,00,00,00
19,05,19,05,19,05,19,05,19,00,00,00,04,00,00,00,00,04,00,00,00,00,00,04,00,00,00,00,00,00,00,00,00,00,00,00,00,00,04,00,00,00,00,00,00,04,00,04,00,04,00,00,00,00,00,00,00,00,00,00,00,00,00,00,00,00,00,00,00,00,00,00,00,00,73,73,73,73,73,73,73,73,00,00,00,00,00,00,00,00,00,00,00,87,87,87,87,87,00,00
00,04,00,04,00,04,00,05,83,00,00,19,05,19,00,00,00,04,00,00,00,00,00,04,00,00,00,00,00,00,00,00,00,00,00,00,00,00,04,00,00,00,00,00,00,04,00,04,00,04,00,00,00,00,00,00,00,00,00,00,00,00,00,00,00,00,00,00,00,00,00,00,00,00,73,73,73,73,73,73,73,73,00,00,00,00,00,00,00,00,00,00,00,73,73,73,73,73,00,00
00,04,00,04,00,04,00,04,00,00,00,82,05,83,00,00,00,04,00,00,00,00,00,04,47,48,48,48,48,48,48,48,48,49,00,00,00,00,04,00,00,00,00,00,00,04,00,04,00,04,00,00,00,00,00,00,00,00,00,00,00,00,00,00,00,00,00,00,00,00,00,00,00,00,73,73,73,73,73,73,73,73,00,00,00,00,87,87,87,87,87,00,00,73,73,73,73,73,00,00
00,00,00,00,02,00,00,04,00,00,00,82,05,83,00,00,00,04,54,00,00,00,54,04,61,62,62,62,62,62,62,62,62,63,00,00,00,00,04,00,00,00,00,00,00,04,00,04,00,04,00,00,00,00,00,00,00,00,00,00,00,00,00,00,00,00,00,00,00,00,00,00,00,00,73,73,73,73,73,73,73,73,00,00,00,00,73,73,73,73,73,00,00,73,73,73,73,73,00,00
00,00,00,00,00,00,00,00,03,00,00,82,05,83,00,00,00,05,05,19,05,05,05,05,75,76,76,76,76,76,76,76,76,77,00,00,00,00,04,00,00,00,00,00,00,04,82,05,83,04,00,00,00,00,00,00,00,00,00,00,00,00,00,00,00,00,00,00,00,00,00,00,00,00,73,73,73,73,73,73,73,73,00,00,00,00,73,73,73,73,73,00,00,73,73,73,73,73,00,00
00,00,00,00,00,00,00,00,00,00,00,00,04,00,00,00,00,04,68,00,68,68,68,04,50,52,52,52,52,52,52,52,52,53,00,00,00,00,04,00,22,00,00,08,08,08,08,68,00,04,00,00,00,00,12,13,13,12,00,00,00,13,00,00,00,00,00,00,00,00,87,87,87,87,87,87,87,87,87,87,87,87,87,87,87,87,87,87,87,87,87,87,87,87,87,87,87,87,87,00
00,00,00,00,00,00,00,00,00,00,00,00,04,00,00,00,00,04,00,00,00,00,00,04,50,51,65,51,51,65,51,65,51,53,00,00,00,60,04,22,22,60,08,22,22,08,22,08,00,04,00,00,00,00,26,27,27,26,00,00,00,27,00,60,00,00,60,60,00,00,73,73,73,73,73,73,73,73,73,73,73,73,73,73,73,73,73,73,73,73,73,73,73,73,73,73,73,73,73,00
12,00,00,00,00,00,00,13,00,00,08,08,08,00,00,00,00,04,00,00,00,00,00,04,50,65,51,65,65,65,51,51,65,53,00,00,01,02,02,02,02,02,02,02,02,02,02,02,02,03,60,60,00,00,40,41,41,40,00,00,60,41,01,02,02,02,02,02,02,02,02,02,02,02,02,02,02,02,78,79,79,79,79,79,79,80,81,81,81,81,78,79,79,79,79,79,79,78,79,80
26,00,00,00,00,00,00,27,00,00,22,22,22,22,00,00,00,04,00,00,00,00,00,04,50,65,65,51,65,51,51,51,52,53,00,00,01,00,00,00,00,00,00,00,00,00,00,00,00,17,02,18,60,37,38,38,38,38,39,60,01,02,02,00,00,00,00,00,00,00,00,00,00,00,33,00,00,00,00,00,00,00,00,00,00,00,00,00,00,00,00,00,00,00,00,00,00,00,00,00
40,00,00,00,00,00,00,41,00,00,22,22,22,22,00,00,00,04,00,00,00,00,00,04,64,65,65,66,66,66,65,65,65,67,00,60,01,00,00,00,00,30,30,30,00,00,00,00,00,00,00,02,02,02,02,02,02,02,02,02,17,00,00,00,00,00,00,00,00,00,00,00,33,33,33,33,33,33,33,33,00,00,00,00,00,00,00,00,00,00,00,00,33,33,00,00,00,00,00,33
00,00,00,00,00,00,00,00,00,00,00,00,00,00,00,00,00,00,00,00,00,00,00,00,00,00,00,00,00,00,00,78,79,79,78,02,15,00,00,00,30,30,00,33,33,33,33,00,00,00,00,00,00,00,00,00,00,00,00,00,00,00,00,00,00,00,00,00,00,00,00,33,33,33,00,00,00,00,00,00,00,00,00,00,00,00,00,00,00,00,00,00,00,33,00,00,00,00,33,33
00,00,00,00,00,00,00,00,00,00,00,00,00,00,00,00,00,00,00,00,00,00,54,33,00,33,33,00,00,00,00,00,00,33,33,33,33,33,00,00,30,00,00,30,30,30,30,00,00,00,00,00,00,00,00,00,00,00,00,00,00,00,00,00,00,00,00,00,00,00,00,00,00,33,00,00,00,00,33,00,00,00,00,00,33,00,00,00,00,00,00,00,00,33,00,00,00,00,33,33
00,00,00,00,00,00,00,00,00,00,00,00,00,00,00,00,00,00,00,00,00,00,04,33,35,35,35,35,33,33,00,35,35,33,35,35,35,00,00,33,00,30,33,30,30,33,33,30,00,00,00,00,00,00,00,00,00,00,00,00,00,00,00,00,00,00,00,00,00,00,00,00,00,00,00,00,00,00,00,00,00,33,33,33,33,00,00,00,00,00,00,00,33,33,00,00,00,00,00,00
00,00,00,00,00,00,00,00,00,00,00,00,00,00,00,00,00,00,00,00,00,33,00,00,33,00,35,35,35,33,33,33,00,35,35,33,33,33,00,00,00,00,00,33,33,33,00,30,00,00,00,00,00,00,00,00,00,00,00,00,00,00,33,33,33,33,33,33,33,33,33,33,33,33,33,33,00,00,00,00,33,33,00,00,00,00,00,33,33,33,33,33,00,33,00,00,00,00,00,00
00,00,00,00,00,00,00,00,00,00,00,00,00,00,00,00,00,00,00,33,33,33,33,33,33,33,35,35,00,33,33,35,35,35,33,33,35,00,00,00,00,00,00,00,00,00,00,00,00,00,00,00,00,00,00,00,00,00,00,33,33,33,33,00,00,00,00,00,00,00,00,00,00,00,00,00,00,00,00,00,00,00,00,00,00,00,00,00,00,00,00,00,00,33,33,00,00,00,00,00